################################################################################
#.......#################################......#####################.###########
##.....################OOOOOOOOOO########......################..........#######
###.......WWwwW:......ooOOOOOOOOO###########.#######.....................#######
###.......wW:W:ww.........ooooooo###########.............................#######
###..:..T.T......................###########.........##########..........#######
###........:.+-=--=-+....T................##########.##########..........#######
###...w:W:...|.0..0.|...........T...ooo...#...###....##########....#############
###...wW:w...|......+--+......TTT..oOOOo.............#############.....#########
###.....0....|.........|.......T...oO#Oo..............##########.........#######
###......:w:.|.0.....0.|...~.......oOOOo.............###########..............##
#.#....wW:...+-=-+.+-=-+.T..........ooo.......T...T..###########...#####......##
#~.........................#####.......T.............########......#####......##
#~~~~..~~~~.~~...........#######...............##############....#######......##
#~~~...oOOo.~~........##########...............####...#######.##########......##
###~~..~~~~..............#########.##########....................#########.#####
####~~......o............#########.###########...................#########.#####
#####~.~~~~~O~~.~~~..###.#########.###########.#################.########.....##
#####~.~~~~~O~~...~~~.##.########...#########..###.#############.########.....##
##.....~~~..o.....~~~~.....######...######.........##########......######.....##
##.........T.~~...~~~........####...######...........######..........####.....##
##.###.~~~...~~~~~~...........####.#######.#######...#........................##
##.....~~~~~...~...................#######.#########.#........................##
##...........T...~~................#######...............##..........####.....##
##.......~~~...~~~~~~........ooOO#########.............######......######.....##
#...........TT..........T......................................................#
#....TTT...........TT(TTTTTTT..........#########################################
#........T...TTTT(TTTT(T...............$.......####........$.............##...##
#....T...........TT(((TTTT.............$.......$....########.............$..#.##
#.........T..........T(T...............$.......#############.............####.##
#.......+-==--==--==-+.................###$#################.............####.##
#.......|............|.................###.#####.........####################.##
#.......|............|.................###.#####.........####################.##
#.......|............|.................###.#####.........###########..........##
#.......+-=-+--.-+-=-+.................###.#####.........###########$###########
#...........|....|.....................###.....$.........$...###.............###
#...........+0..0+.....................#########.........###.###.............###
#......................................###########$#########...$.............###
#......................................#####.......#################$###########
################################################################################